⽇	a	康熙部首
⽈	a	康熙部首
⿱	a	表意文字描述字符
㍾	aber	中日韓兼容符號
暈	abjj	中日韓兼容表意文字
冒	abu	中日韓兼容表意文字補充
㒻	abuu	中日韓兼容表意文字補充
㬙	aikf	中日韓兼容表意文字補充
㫤	aine	中日韓兼容表意文字補充
䳭	aislf	中日韓兼容表意文字補充
暑	ajka	中日韓兼容表意文字
暑	ajka	中日韓兼容表意文字補充
量	amwg	中日韓兼容表意文字
⾨	an	康熙部首
冕	anau	中日韓兼容表意文字補充
開	anmjj	中日韓兼容表意文字補充
閭	anrhr	中日韓兼容表意文字
𨵷	anwot	中日韓兼容表意文字補充
䦕	anyjj	中日韓兼容表意文字補充
易	aphh	中日韓兼容表意文字
即	apsl	中日韓兼容表意文字補充
晴	aqmb	中日韓兼容表意文字
晴	aqmb	中日韓兼容表意文字
最	asje	中日韓兼容表意文字補充
㍼	asrr	中日韓兼容符號
暴	atce	中日韓兼容表意文字
⾉	av	康熙部首
㬈	awot	中日韓兼容表意文字補充
⽉	b	康熙部首
⺝	b	中日韓部首補充
⺼	b	中日韓部首補充
⾻	bbb	康熙部首
⻣	bbb	中日韓部首補充
𠕋	bbmm	中日韓兼容表意文字補充
䯎	bbomj	中日韓兼容表意文字補充
亂	bbu	中日韓兼容表意文字
鼏	bbul	中日韓兼容表意文字補充
鼏	bbun	中日韓兼容表意文字補充
⺳	bc	中日韓部首補充
贈	bccwa	中日韓兼容表意文字
贈	bccwa	中日韓兼容表意文字
賂	bcher	中日韓兼容表意文字
䐋	bcip	中日韓兼容表意文字補充
炙	bf	中日韓兼容表意文字
媵	bfqv	中日韓兼容表意文字補充
瞧	bgf	中日韓兼容表意文字
𦞵	bham	中日韓兼容表意文字補充
𦞧	bhhw	中日韓兼容表意文字補充
𧲨	bhmjj	中日韓兼容表意文字補充
冗	bhu	中日韓兼容表意文字補充
⺴	bhu	中日韓部首補充
⻅	bhu	中日韓部首補充
⺼	bim	中日韓部首補充
⺱	bk	中日韓部首補充
⽹	bkk	康熙部首
𦋙	bkkhu	中日韓兼容表意文字補充
肋	bks	中日韓兼容表意文字
䏙	blbu	中日韓兼容表意文字補充
⺵	bll	中日韓部首補充
⼞	bm	康熙部首
𣍟	bmb	中日韓兼容表意文字補充
䏕	bmg	中日韓兼容表意文字補充
⺜	bmm	中日韓部首補充
脃	bnau	中日韓兼容表意文字補充
⻉	bo	中日韓部首補充
肭	bob	中日韓兼容表意文字補充
⽤	bq	康熙部首
周	bqr	中日韓兼容表意文字補充
彫	brhhh	中日韓兼容表意文字補充
𣎜	brxu	中日韓兼容表意文字補充
⾘	bshh	康熙部首
冤	bshi	中日韓兼容表意文字補充
⽫	bt	康熙部首
⽬	bu	康熙部首
⿳	bu	表意文字描述字符
⾙	buc	康熙部首
朡	buce	中日韓兼容表意文字補充
見	buhu	中日韓兼容表意文字
⾒	buhu	康熙部首
睊	buib	中日韓兼容表意文字
睊	buib	中日韓兼容表意文字補充
䁆	bukhu	中日韓兼容表意文字補充
䀹	bukoo	中日韓兼容表意文字
䀹	bukoo	中日韓兼容表意文字補充
具	bumc	中日韓兼容表意文字補充
𥄙	bumf	中日韓兼容表意文字補充
䀘	bumjj	中日韓兼容表意文字
𥃳	bumms	中日韓兼容表意文字補充
𥉉	buold	中日韓兼容表意文字
瞋	bupbc	中日韓兼容表意文字補充
𥃲	but	中日韓兼容表意文字補充
⿍	buvml	康熙部首
臘	bvvv	中日韓兼容表意文字
脾	bwhj	中日韓兼容表意文字補充
爵	bwli	中日韓兼容表意文字
爵	bwli	中日韓兼容表意文字補充
丹	by	中日韓兼容表意文字
𣎓	byso	中日韓兼容表意文字補充
金	c	中日韓兼容表意文字
⾦	c	康熙部首
鍊	cdwf	中日韓兼容表意文字
⺑	chn	中日韓部首補充
⺏	chu	中日韓部首補充
𨯺	chxf	中日韓兼容表意文字補充
鋗	cib	中日韓兼容表意文字補充
鈸	cike	中日韓兼容表意文字補充
⽗	ck	康熙部首
鐕	ckua	中日韓兼容表意文字補充
益	cmct	中日韓兼容表意文字
鉶	cmjn	中日韓兼容表意文字
鏹	cnri	中日韓兼容表意文字補充
鈴	coml	中日韓兼容表意文字
⾕	cor	康熙部首
鋘	crvk	中日韓兼容表意文字補充
錄	cvne	中日韓兼容表意文字
鉼	cyjj	中日韓兼容表意文字補充
⽊	d	康熙部首
欄	danw	中日韓兼容表意文字
𣑭	dbbm	中日韓兼容表意文字補充
刺	dbln	中日韓兼容表意文字
榣	dbou	中日韓兼容表意文字補充
㮝	dcrl	中日韓兼容表意文字
㮝	dcrl	中日韓兼容表意文字補充
林	dd	中日韓兼容表意文字
楂	ddbm	中日韓兼容表意文字補充
㓟	deln	中日韓兼容表意文字補充
隸	dfle	中日韓兼容表意文字
櫛	dhal	中日韓兼容表意文字補充
梎	dhap	中日韓兼容表意文字補充
⽪	dhe	康熙部首
柳	dhhl	中日韓兼容表意文字
槪	dhpu	中日韓兼容表意文字補充
⼨	di	康熙部首
𣏕	dijc	中日韓兼容表意文字
杖	dijk	中日韓兼容表意文字
𣏃	dl	中日韓兼容表意文字補充
樓	dllv	中日韓兼容表意文字
𪈎	dlmcf	中日韓兼容表意文字補充
⺘	dm	中日韓部首補充
枅	dmjj	中日韓兼容表意文字補充
㍿	dmoig	中日韓兼容符號
⾱	dmrq	康熙部首
李	dnd	中日韓兼容表意文字
杻	dng	中日韓兼容表意文字
𦖨	dnsj	中日韓兼容表意文字補充
櫓	dnwa	中日韓兼容表意文字
⿆	doni	康熙部首
來	doo	中日韓兼容表意文字
梅	dowj	中日韓兼容表意文字補充
梅	dowy	中日韓兼容表意文字
杓	dpm	中日韓兼容表意文字補充
韛	dqthb	中日韓兼容表意文字
韠	dqwtj	中日韓兼容表意文字補充
柺	drks	中日韓兼容表意文字補充
𣏃	dsm	中日韓兼容表意文字補充
㰘	dsmt	中日韓兼容表意文字補充
杞	dsu	中日韓兼容表意文字補充
檨	dtgo	中日韓兼容表意文字補充
椔	dvmw	中日韓兼容表意文字補充
𣚣	dwtc	中日韓兼容表意文字補充
栟	dyjj	中日韓兼容表意文字補充
⽔	e	康熙部首
𣽞	eahr	中日韓兼容表意文字補充
涅	eam	中日韓兼容表意文字補充
滑	ebbb	中日韓兼容表意文字
洞	ebmr	中日韓兼容表意文字
滛	ebmu	中日韓兼容表意文字
梁	ecd	中日韓兼容表意文字
𣴞	ecsg	中日韓兼容表意文字補充
淋	edd	中日韓兼容表意文字
㴳	egih	中日韓兼容表意文字補充
洛	eher	中日韓兼容表意文字
派	ehhv	中日韓兼容表意文字補充
溜	ehhw	中日韓兼容表意文字
沿	ehnr	中日韓兼容表意文字補充
浩	ehqr	中日韓兼容表意文字補充
淚	ehsk	中日韓兼容表意文字
浪	eiav	中日韓兼容表意文字
潮	ejjb	中日韓兼容表意文字補充
渚	ejka	中日韓兼容表意文字
濆	ejtc	中日韓兼容表意文字補充
𣲼	ekbn	中日韓兼容表意文字補充
𣻑	ekce	中日韓兼容表意文字補充
淹	ekhu	中日韓兼容表意文字補充
灊	ekub	中日韓兼容表意文字補充
沈	elbu	中日韓兼容表意文字
𣾎	emef	中日韓兼容表意文字補充
汧	emjj	中日韓兼容表意文字補充
湮	emwg	中日韓兼容表意文字補充
溺	enhh	中日韓兼容表意文字
汎	enhi	中日韓兼容表意文字補充
㶖	eolf	中日韓兼容表意文字補充
淪	eomb	中日韓兼容表意文字
瀹	eomb	中日韓兼容表意文字補充
海	eowj	中日韓兼容表意文字補充
海	eowy	中日韓兼容表意文字
滇	epbc	中日韓兼容表意文字補充
泌	eph	中日韓兼容表意文字
瀞	eqbd	中日韓兼容表意文字
瀞	eqbd	中日韓兼容表意文字補充
泍	eqc	中日韓兼容表意文字補充
洖	ervk	中日韓兼容表意文字補充
漏	esmb	中日韓兼容表意文字
浸	esme	中日韓兼容表意文字補充
濫	esmt	中日韓兼容表意文字
泥	esp	中日韓兼容表意文字
漢	etao	中日韓兼容表意文字
港	etcu	中日韓兼容表意文字補充
漢	etlo	中日韓兼容表意文字
滋	etvi	中日韓兼容表意文字
滋	etvi	中日韓兼容表意文字補充
流	eyiu	中日韓兼容表意文字
流	eyiu	中日韓兼容表意文字
流	eyiv	中日韓兼容表意文字補充
漣	eyjj	中日韓兼容表意文字
洴	eyjj	中日韓兼容表意文字補充
濾	eypp	中日韓兼容表意文字
瀛	eyqv	中日韓兼容表意文字補充
⽕	f	康熙部首
爛	fanw	中日韓兼容表意文字
⽶	fd	康熙部首
糧	fdamg	中日韓兼容表意文字
类	fdik	中日韓兼容表意文字
糖	fdilr	中日韓兼容表意文字
糣	fdkua	中日韓兼容表意文字補充
類	fdmbc	中日韓兼容表意文字
糨	fdnri	中日韓兼容表意文字補充
精	fdqmb	中日韓兼容表意文字
糒	fdthb	中日韓兼容表意文字補充
煉	fdwf	中日韓兼容表意文字
料	fdyj	中日韓兼容表意文字
粒	fdyt	中日韓兼容表意文字
⺢	ff	中日韓部首補充
勞	ffbks	中日韓兼容表意文字
瑩	ffbmi	中日韓兼容表意文字
燐	ffdq	中日韓兼容表意文字
𤎫	ffto	中日韓兼容表意文字補充
虩	ffypu	中日韓兼容表意文字補充
省	fhbu	中日韓兼容表意文字
烙	fher	中日韓兼容表意文字
劣	fhks	中日韓兼容表意文字
熜	fhwp	中日韓兼容表意文字補充
⺗	fi	中日韓部首補充
燎	fkcf	中日韓兼容表意文字
煅	frse	中日韓兼容表意文字補充
当	fsm	中日韓兼容表意文字補充
灷	ft	中日韓兼容表意文字補充
兤	fuitc	中日韓兼容表意文字補充
𤉣	fvmw	中日韓兼容表意文字補充
爐	fypt	中日韓兼容表意文字
⼟	g	康熙部首
売	gbhn	中日韓兼容表意文字補充
塚	gbmo	中日韓兼容表意文字
塚	gbmo	中日韓兼容表意文字
壷	gbtm	中日韓兼容表意文字補充
穀	gdhne	中日韓兼容表意文字
穀	gdhne	中日韓兼容表意文字補充
𡓤	ghoc	中日韓兼容表意文字補充
城	gihn	中日韓兼容表意文字補充
城	gihs	中日韓兼容表意文字補充
報	gjrle	中日韓兼容表意文字補充
墳	gjtc	中日韓兼容表意文字
⾚	glnc	康熙部首
殻	gnhne	中日韓兼容表意文字補充
𠠄	gofbn	中日韓兼容表意文字補充
𧼯	goomv	中日韓兼容表意文字補充
起	gosu	中日韓兼容表意文字補充
𧻓	goyjj	中日韓兼容表意文字
埴	gpbv	中日韓兼容表意文字補充
嗀	grhne	中日韓兼容表意文字
切	gsh	中日韓兼容表意文字補充
堍	gshi	中日韓兼容表意文字補充
塀	gsyj	中日韓兼容表意文字
⿎	gtje	康熙部首
⾛	gyo	康熙部首
⼃	h	康熙部首
⽵	h	康熙部首
㇒	h	中日韓筆畫
⽩	ha	康熙部首
馧	haabt	中日韓兼容表意文字補充
⾹	had	康熙部首
𤾡	haikf	中日韓兼容表意文字補充
節	hail	中日韓兼容表意文字
𥳐	hanj	中日韓兼容表意文字
𤾸	hatbf	中日韓兼容表意文字補充
⿃	hayf	康熙部首
爨	hbddf	中日韓兼容表意文字補充
𥮫	hbfd	中日韓兼容表意文字補充
䈧	hbhf	中日韓兼容表意文字補充
⾎	hbt	康熙部首
⾃	hbu	康熙部首
⾈	hbyi	康熙部首
劉	hcln	中日韓兼容表意文字
⽲	hd	康熙部首
穏	hdbsp	中日韓兼容表意文字補充
稜	hdgce	中日韓兼容表意文字
彩	hdhhh	中日韓兼容表意文字
秊	hdhj	中日韓兼容表意文字
穊	hdhpu	中日韓兼容表意文字補充
秫	hdid	中日韓兼容表意文字補充
利	hdln	中日韓兼容表意文字
䄯	hdmjj	中日韓兼容表意文字補充
⿉	hdoe	康熙部首
⼡	he	康熙部首
⼢	he	康熙部首
冬	heim	中日韓兼容表意文字補充
爫	hf	中日韓兼容表意文字
⺣	hf	中日韓部首補充
⺤	hf	中日韓部首補充
⺥	hf	中日韓部首補充
⾤	hfd	康熙部首
⺧	hg	中日韓部首補充
珞	hgher	中日韓兼容表意文字
⺁	hh	中日韓部首補充
卿	hhapl	中日韓兼容表意文字補充
⼺	hhh	康熙部首
卿	hhhil	中日韓兼容表意文字補充
⾡	hhho	康熙部首
卿	hhhpl	中日韓兼容表意文字補充
𨜮	hhisl	中日韓兼容表意文字補充
黎	hhoe	中日韓兼容表意文字
節	hhsl	中日韓兼容表意文字
卵	hhsli	中日韓兼容表意文字
留	hhw	中日韓兼容表意文字
㇛	hi	中日韓筆畫
簾	hihc	中日韓兼容表意文字
⾆	hjr	康熙部首
翺	hjsmm	中日韓兼容表意文字補充
懲	hkp	中日韓兼容表意文字
懲	hkp	中日韓兼容表意文字
懲	hkp	中日韓兼容表意文字補充
⺅	hl	中日韓部首補充
齃	hlapp	中日韓兼容表意文字
堲	hlg	中日韓兼容表意文字補充
⽖	hlo	康熙部首
𡷦	hlu	中日韓兼容表意文字補充
⽄	hml	康熙部首
築	hmnd	中日韓兼容表意文字補充
⼏	hn	康熙部首
⺇	hn	中日韓部首補充
⺈	hn	中日韓部首補充
梨	hnd	中日韓兼容表意文字
⽎	hne	康熙部首
⾵	hnhli	康熙部首
𩖶	hnid	中日韓兼容表意文字補充
⻛	hnk	中日韓部首補充
⼋	ho	康熙部首
⼻	ho	康熙部首
徭	hobmu	中日韓兼容表意文字
徚	hodw	中日韓兼容表意文字補充
㣣	hokoo	中日韓兼容表意文字補充
律	holq	中日韓兼容表意文字
行	hommn	中日韓兼容表意文字
⾏	hommn	康熙部首
𣢧	hono	中日韓兼容表意文字補充
復	hooae	中日韓兼容表意文字
衠	hopcn	中日韓兼容表意文字補充
𠨬	hp	中日韓兼容表意文字補充
旣	hpmvu	中日韓兼容表意文字補充
卽	hpsl	中日韓兼容表意文字補充
⽜	hq	康熙部首
⽣	hqm	康熙部首
夆	hqqj	中日韓兼容表意文字補充
犕	hqthb	中日韓兼容表意文字補充
⽑	hqu	康熙部首
⾩	hrj	康熙部首
⻕	hrlr	中日韓部首補充
⼓	hs	康熙部首
⼾	hs	康熙部首
⺆	hs	中日韓部首補充
篆	hsmo	中日韓兼容表意文字補充
既	hsmvu	中日韓兼容表意文字
䀈	hubt	中日韓兼容表意文字補充
䊠	hufd	中日韓兼容表意文字補充
⿁	hui	康熙部首
⻤	hui	中日韓部首補充
臭	huik	中日韓兼容表意文字
鱀	hunwf	中日韓兼容表意文字補充
𦓚	huumb	中日韓兼容表意文字補充
⿐	huwml	康熙部首
鼻	huwt	中日韓兼容表意文字補充
㇢	hv	中日韓筆畫
⽠	hvio	康熙部首
⽒	hvp	康熙部首
𥲀	hvvd	中日韓兼容表意文字補充
卑	hwhj	中日韓兼容表意文字
卑	hwhj	中日韓兼容表意文字補充
⾅	hx	康熙部首
⺽	hx	中日韓部首補充
⾝	hxh	康熙部首
䳎	hxhaf	中日韓兼容表意文字補充
𠔜	hxlc	中日韓兼容表意文字補充
舁	hxt	中日韓兼容表意文字補充
舁	hxt	中日韓兼容表意文字補充
龜	hxu	中日韓兼容表意文字
龜	hxu	中日韓兼容表意文字
⻱	hxu	中日韓部首補充
舄	hxvsf	中日韓兼容表意文字補充
⿏	hxvyv	康熙部首
⺖	hy	中日韓部首補充
籠	hybp	中日韓兼容表意文字
䈂	hyjj	中日韓兼容表意文字補充
笠	hyt	中日韓兼容表意文字
䑫	hyyjj	中日韓兼容表意文字補充
⼂	i	康熙部首
⼽	i	康熙部首
㇔	i	中日韓筆畫
良	iav	中日韓兼容表意文字
⼧	ib	康熙部首
䳸	ichaf	中日韓兼容表意文字補充
麻	idd	中日韓兼容表意文字補充
𪎒	idhni	中日韓兼容表意文字補充
摩	idq	中日韓兼容表意文字補充
視	ifbuu	中日韓兼容表意文字
視	ifbuu	中日韓兼容表意文字
𥛅	ifhlw	中日韓兼容表意文字補充
𥘦	ifok	中日韓兼容表意文字補充
福	ifslw	中日韓兼容表意文字補充
𥚚	ifyhu	中日韓兼容表意文字補充
𥚚	ifyku	中日韓兼容表意文字補充
廉	ihhc	中日韓兼容表意文字
成	ihmn	中日韓兼容表意文字補充
成	ihs	中日韓兼容表意文字補充
廊	ihvl	中日韓兼容表意文字補充
⺀	ii	中日韓部首補充
朗	iib	中日韓兼容表意文字
⺍	iih	中日韓部首補充
參	iiih	中日韓兼容表意文字
⽧	iim	康熙部首
⺡	iim	中日韓部首補充
⻍	iino	中日韓部首補充
廊	iivl	中日韓兼容表意文字
⿇	ijcc	康熙部首
唐	ijsr	中日韓兼容表意文字補充
⽝	ik	康熙部首
⻰	ikp	中日韓部首補充
啓	ikr	中日韓兼容表意文字補充
㡼	ilwp	中日韓兼容表意文字補充
⼇	im	康熙部首
⼎	im	康熙部首
凌	imgce	中日韓兼容表意文字
次	imno	中日韓兼容表意文字補充
冷	imoml	中日韓兼容表意文字
𩇟	imqbu	中日韓兼容表意文字補充
凉	imyrf	中日韓兼容表意文字
凜	imywd	中日韓兼容表意文字
⼍	in	康熙部首
盛	inbt	中日韓兼容表意文字
⺭	inf	中日韓部首補充
⻂	inlo	中日韓部首補充
⻎	inno	中日韓部首補充
辶	ino	中日韓兼容表意文字
⻌	ino	中日韓部首補充
⻂	inol	中日韓部首補充
⻈	inv	中日韓部首補充
⼷	ip	康熙部首
麟	ipfdq	中日韓兼容表意文字
𪊑	ipmjj	中日韓兼容表意文字補充
廒	iqsk	中日韓兼容表意文字
度	ite	中日韓兼容表意文字
庶	itf	中日韓兼容表意文字補充
凞	iuf	中日韓兼容表意文字
朗	ivb	中日韓兼容表意文字
朗	ivb	中日韓兼容表意文字補充
⽞	ivi	康熙部首
剆	ivln	中日韓兼容表意文字補充
郎	ivnl	中日韓兼容表意文字
庳	iwlj	中日韓兼容表意文字補充
恵	iwp	中日韓兼容表意文字
廙	iwtc	中日韓兼容表意文字
鹿	ixp	中日韓兼容表意文字
⿅	ixp	康熙部首
廓	iydl	中日韓兼容表意文字
庰	iyjj	中日韓兼容表意文字補充
廬	iypt	中日韓兼容表意文字
⼗	j	康熙部首
煮	jaf	中日韓兼容表意文字
煮	jaf	中日韓兼容表意文字
都	janl	中日韓兼容表意文字
直	jbmm	中日韓兼容表意文字
𩐊	jbmom	中日韓兼容表意文字補充
真	jbuc	中日韓兼容表意文字補充
直	jbuv	中日韓兼容表意文字補充
索	jbvf	中日韓兼容表意文字
⽳	jc	康熙部首
突	jcik	中日韓兼容表意文字
𥥼	jcjbt	中日韓兼容表意文字補充
窱	jcold	中日韓兼容表意文字
⽀	je	康熙部首
鶴	jghaf	中日韓兼容表意文字
宅	jhp	中日韓兼容表意文字
牢	jhq	中日韓兼容表意文字
博	jiji	中日韓兼容表意文字補充
戴	jiwtc	中日韓兼容表意文字
艹	jj	中日韓兼容表意文字
廾	jj	中日韓兼容表意文字補充
⼶	jj	康熙部首
⺾	jj	中日韓部首補充
⺿	jj	中日韓部首補充
輻	jjmrw	中日韓兼容表意文字
輪	jjomb	中日韓兼容表意文字
輸	jjomn	中日韓兼容表意文字
輸	jjomv	中日韓兼容表意文字補充
軔	jjsk	中日韓兼容表意文字補充
轢	jjvid	中日韓兼容表意文字
⺹	jk	中日韓部首補充
者	jka	中日韓兼容表意文字
者	jka	中日韓兼容表意文字
寮	jkcf	中日韓兼容表意文字
者	jkia	中日韓兼容表意文字補充
老	jkp	中日韓兼容表意文字
⽼	jkp	康熙部首
吏	jlk	中日韓兼容表意文字
⼠	jm	康熙部首
寳	jmfc	中日韓兼容表意文字補充
賓	jmhc	中日韓兼容表意文字
𡧈	jmms	中日韓兼容表意文字補充
⿆	joni	康熙部首
寘	jpbc	中日韓兼容表意文字補充
寧	jpbn	中日韓兼容表意文字
寧	jpbn	中日韓兼容表意文字
寧	jpwn	中日韓兼容表意文字補充
憲	jqjp	中日韓兼容表意文字補充
割	jrln	中日韓兼容表意文字補充
⺺	js	中日韓部首補充
寃	jshi	中日韓兼容表意文字補充
卉	jt	中日韓兼容表意文字補充
賁	jtbc	中日韓兼容表意文字補充
塞	jtcg	中日韓兼容表意文字
桒	jtd	中日韓兼容表意文字補充
鼖	jtge	中日韓兼容表意文字補充
真	jumc	中日韓兼容表意文字補充
車	jwj	中日韓兼容表意文字
⾞	jwj	康熙部首
⼤	k	康熙部首
瘟	kabt	中日韓兼容表意文字
殺	kchne	中日韓兼容表意文字補充
閷	kdano	中日韓兼容表意文字補充
殺	kdhne	中日韓兼容表意文字
殺	kdhne	中日韓兼容表意文字
癩	kdlc	中日韓兼容表意文字
𪄅	kehaf	中日韓兼容表意文字補充
⺨	kh	中日韓部首補充
獺	khdlc	中日韓兼容表意文字補充
痢	khdn	中日韓兼容表意文字
狼	khiav	中日韓兼容表意文字
𤠔	khibc	中日韓兼容表意文字補充
猪	khjka	中日韓兼容表意文字
猪	khjka	中日韓兼容表意文字
𤜵	khmjj	中日韓兼容表意文字補充
犯	khru	中日韓兼容表意文字
獵	khvvv	中日韓兼容表意文字
⼶	kj	康熙部首
奢	kjka	中日韓兼容表意文字補充
奔	kjt	中日韓兼容表意文字
⽘	kk	康熙部首
療	kkcf	中日韓兼容表意文字
瘐	klwo	中日韓兼容表意文字補充
奈	kmmf	中日韓兼容表意文字
㍽	kmym	中日韓兼容符號
丸	knk	中日韓兼容表意文字補充
⻋	kq	中日韓部首補充
力	ks	中日韓兼容表意文字
⼒	ks	康熙部首
尢	ku	中日韓兼容表意文字補充
⼪	ku	康熙部首
⺐	ku	中日韓部首補充
㞁	kuap	中日韓兼容表意文字補充
瘝	kwle	中日韓兼容表意文字
奄	kwu	中日韓兼容表意文字
⼁	l	康熙部首
㇑	l	中日韓筆畫
㇓	l	中日韓筆畫
褐	lapv	中日韓兼容表意文字
⼱	lb	康熙部首
帽	lbabu	中日韓兼容表意文字補充
㡢	lbaws	中日韓兼容表意文字補充
帨	lbcru	中日韓兼容表意文字補充
幩	lbjtc	中日韓兼容表意文字補充
⽱	lbmi	康熙部首
𢆃	lbtye	中日韓兼容表意文字補充
⺌	lc	中日韓部首補充
裞	lcru	中日韓兼容表意文字補充
懶	ldlc	中日韓兼容表意文字
⾪	le	康熙部首
書	lga	中日韓兼容表意文字補充
蝹	liabt	中日韓兼容表意文字補充
蟡	libhf	中日韓兼容表意文字補充
䗗	lihmj	中日韓兼容表意文字補充
蜎	liib	中日韓兼容表意文字補充
蝫	lijka	中日韓兼容表意文字補充
⺦	lim	中日韓部首補充
蚈	limjj	中日韓兼容表意文字補充
⻔	lis	中日韓部首補充
螆	litvi	中日韓兼容表意文字補充
䗹	litvp	中日韓兼容表意文字補充
蠟	livvv	中日韓兼容表意文字
蝹	liwot	中日韓兼容表意文字
螺	liwvf	中日韓兼容表意文字
蛢	liyjj	中日韓兼容表意文字補充
蜨	liyso	中日韓兼容表意文字補充
裺	lkhu	中日韓兼容表意文字補充
串	ll	中日韓兼容表意文字
牐	llhjl	中日韓兼容表意文字補充
⽚	llml	康熙部首
⽚	llmn	康熙部首
⺊	lm	中日韓部首補充
⺻	lm	中日韓部首補充
㇄	lm	中日韓筆畫
㇗	lm	中日韓筆畫
㇘	lm	中日韓筆畫
将	lmbdi	中日韓兼容表意文字補充
壮	lmg	中日韓兼容表意文字補充
⾍	lmi	康熙部首
北	lmp	中日韓兼容表意文字
北	lmp	中日韓兼容表意文字補充
⾮	lmsy	康熙部首
𧙧	lmt	中日韓兼容表意文字補充
艹	lmy	中日韓兼容表意文字
⻀	lmy	中日韓部首補充
⼍	ln	康熙部首
⾾	ln	康熙部首
⺉	ln	中日韓部首補充
㇁	ln	中日韓筆畫
襁	lnii	中日韓兼容表意文字
䘵	lnme	中日韓兼容表意文字補充
冀	lpwtc	中日韓兼容表意文字
⾀	lq	康熙部首
⼌	ls	康熙部首
⺆	ls	中日韓部首補充
⾲	lsmm	康熙部首
襤	lsmt	中日韓兼容表意文字
㠯	lss	中日韓兼容表意文字補充
⼉	lu	康熙部首
㇂	lv	中日韓筆畫
數	lvok	中日韓兼容表意文字
裸	lwd	中日韓兼容表意文字
裡	lwg	中日韓兼容表意文字
叟	lwle	中日韓兼容表意文字補充
𤰶	lwll	中日韓兼容表意文字補充
𢆟	lwyjj	中日韓兼容表意文字補充
裗	lyiv	中日韓兼容表意文字補充
⼀	m	康熙部首
㇀	m	中日韓筆畫
㇐	m	中日韓筆畫
鄑	manl	中日韓兼容表意文字補充
𩅅	mbett	中日韓兼容表意文字補充
覆	mbhoe	中日韓兼容表意文字
霣	mbibc	中日韓兼容表意文字補充
勵	mbks	中日韓兼容表意文字
⽽	mbll	康熙部首
⻚	mbo	中日韓部首補充
零	mboml	中日韓兼容表意文字
露	mbrmr	中日韓兼容表意文字
靈	mbrro	中日韓兼容表意文字
⾴	mbuc	康熙部首
𠄢	mbvm	中日韓兼容表意文字補充
雷	mbw	中日韓兼容表意文字
祖	mcbm	中日韓兼容表意文字補充
⻄	mcw	中日韓部首補充
⾣	mcwm	康熙部首
不	mf	中日韓兼容表意文字
灰	mf	中日韓兼容表意文字補充
禍	mfbbr	中日韓兼容表意文字
祖	mfbm	中日韓兼容表意文字
視	mfbuu	中日韓兼容表意文字
社	mfg	中日韓兼容表意文字
祈	mfhml	中日韓兼容表意文字
祐	mfkr	中日韓兼容表意文字
神	mflwl	中日韓兼容表意文字
福	mfmrw	中日韓兼容表意文字
祝	mfrhu	中日韓兼容表意文字
祥	mftq	中日韓兼容表意文字
禮	mftwt	中日韓兼容表意文字
礼	mfu	中日韓兼容表意文字
祿	mfvne	中日韓兼容表意文字
禎	mfybc	中日韓兼容表意文字
祉	mfylm	中日韓兼容表意文字
王	mg	中日韓兼容表意文字補充
⺩	mg	中日韓部首補充
再	mgb	中日韓兼容表意文字補充
玥	mgb	中日韓兼容表意文字補充
璘	mgfdq	中日韓兼容表意文字
㺬	mghni	中日韓兼容表意文字補充
⽟	mgi	康熙部首
瑱	mgjbc	中日韓兼容表意文字
琢	mgmso	中日韓兼容表意文字
瓊	mgnwe	中日韓兼容表意文字補充
玲	mgoml	中日韓兼容表意文字
瑜	mgomv	中日韓兼容表意文字補充
瑱	mgpbc	中日韓兼容表意文字補充
瑇	mgqmh	中日韓兼容表意文字補充
弄	mgt	中日韓兼容表意文字
璅	mgvvd	中日韓兼容表意文字補充
理	mgwg	中日韓兼容表意文字
琉	mgyiu	中日韓兼容表意文字
璉	mgyjj	中日韓兼容表意文字
⼚	mh	康熙部首
⺂	mh	中日韓部首補充
㇇	mh	中日韓筆畫
㇖	mh	中日韓筆畫
曆	mhda	中日韓兼容表意文字
歷	mhdm	中日韓兼容表意文字
𤘈	mhhx	中日韓兼容表意文字補充
⾄	mig	康熙部首
䂖	mir	中日韓兼容表意文字補充
⼲	mj	康熙部首
㿼	mjbt	中日韓兼容表意文字補充
㍻	mjihs	中日韓兼容符號
鳽	mjmjf	中日韓兼容表意文字補充
雃	mjmjg	中日韓兼容表意文字補充
形	mjmjh	中日韓兼容表意文字補充
㼛	mjmjn	中日韓兼容表意文字補充
揅	mjq	中日韓兼容表意文字補充
⽆	mku	康熙部首
㇕	ml	中日韓筆畫
兩	mlbo	中日韓兼容表意文字
⾬	mlby	康熙部首
⻗	mlby	中日韓部首補充
⻃	mllw	中日韓部首補充
⼯	mlm	康熙部首
画	mluw	中日韓兼容表意文字
更	mlwk	中日韓兼容表意文字
⼆	mm	康熙部首
晉	mma	中日韓兼容表意文字補充
麗	mmbbp	中日韓兼容表意文字
丽	mmbmb	中日韓兼容表意文字補充
⽰	mmf	康熙部首
⺬	mmf	中日韓部首補充
戛	mmi	中日韓兼容表意文字補充
辰	mmmo	中日韓兼容表意文字
⾠	mmmv	康熙部首
惡	mmp	中日韓兼容表意文字
况	mmrhu	中日韓兼容表意文字
况	mmrhu	中日韓兼容表意文字補充
𥁄	mmst	中日韓兼容表意文字補充
殟	mnabt	中日韓兼容表意文字補充
烈	mnf	中日韓兼容表意文字
型	mng	中日韓兼容表意文字補充
歹	mni	中日韓兼容表意文字
⽍	mni	康熙部首
列	mnln	中日韓兼容表意文字
殮	mnomo	中日韓兼容表意文字
裂	mnyhv	中日韓兼容表意文字
乁	mo	中日韓兼容表意文字補充
㇝	mo	中日韓筆畫
甤	mohqm	中日韓兼容表意文字補充
𧢮	mpbuu	中日韓兼容表意文字補充
⽯	mr	康熙部首
䃣	mrbhf	中日韓兼容表意文字補充
⿀	mrbj	康熙部首
磻	mrhdw	中日韓兼容表意文字
碑	mrhwj	中日韓兼容表意文字
磌	mrjbc	中日韓兼容表意文字
磌	mrjbc	中日韓兼容表意文字補充
硎	mrmjn	中日韓兼容表意文字補充
磊	mrmrr	中日韓兼容表意文字
礪	mrmtb	中日韓兼容表意文字
碌	mrnme	中日韓兼容表意文字補充
𥐝	mrpm	中日韓兼容表意文字補充
⾖	mrt	康熙部首
碌	mrvne	中日韓兼容表意文字
硫	mryiu	中日韓兼容表意文字
辞	mrytj	中日韓兼容表意文字補充
⾗	msho	康熙部首
𩒖	mtmbc	中日韓兼容表意文字補充
兀	mu	中日韓兼容表意文字
⺎	mu	中日韓部首補充
⾑	mub	康熙部首
頋	mumbc	中日韓兼容表意文字
䪲	mumbc	中日韓兼容表意文字補充
頋	mumbc	中日韓兼容表意文字補充
頋	mumbc	中日韓兼容表意文字補充
⼕	mv	康熙部首
⼖	mv	康熙部首
⽛	mvdh	康熙部首
⺛	mvku	中日韓部首補充
⽡	mvni	康熙部首
賈	mwbuc	中日韓兼容表意文字
栗	mwd	中日韓兼容表意文字
酪	mwher	中日韓兼容表意文字
醙	mwhxe	中日韓兼容表意文字
⾯	mwsl	康熙部首
醴	mwtwt	中日韓兼容表意文字
𩈚	mwyjj	中日韓兼容表意文字補充
龎	mybl	中日韓兼容表意文字
⼅	n	康熙部首
⼸	n	康熙部首
㇚	n	中日韓筆畫
⾊	nau	康熙部首
⾓	nbg	康熙部首
勇	nbks	中日韓兼容表意文字
⻇	nboo	中日韓部首補充
⻆	nbq	中日韓部首補充
⼩	nc	康熙部首
⼦	nd	康熙部首
鱗	nffdq	中日韓兼容表意文字
及	nhe	中日韓兼容表意文字補充
⼣	ni	康熙部首
⽭	ninh	康熙部首
多	nini	中日韓兼容表意文字補充
⾇	niq	康熙部首
⽨	niyo	康熙部首
⼜	nk	康熙部首
⻏	nl	中日韓部首補充
⻖	nl	中日韓部首補充
隣	nlfdq	中日韓兼容表意文字
陵	nlgce	中日韓兼容表意文字
陸	nlgcg	中日韓兼容表意文字
隆	nlheg	中日韓兼容表意文字
降	nlheq	中日韓兼容表意文字
䧦	nlikf	中日韓兼容表意文字補充
陼	nljka	中日韓兼容表意文字
陋	nlmbv	中日韓兼容表意文字
阮	nlmmu	中日韓兼容表意文字
⼹	nmm	康熙部首
了	nn	中日韓兼容表意文字
㇆	nn	中日韓筆畫
㇋	nn	中日韓筆畫
㇎	nn	中日韓筆畫
⼵	nnk	康熙部首
⽋	no	康熙部首
⻜	no	中日韓部首補充
𠭣	noe	中日韓兼容表意文字補充
墬	nog	中日韓兼容表意文字補充
⾶	nohto	康熙部首
㇌	ns	中日韓筆畫
㇡	ns	中日韓筆畫
豕	nsho	中日韓兼容表意文字補充
⼄	nu	康熙部首
㇠	nu	中日韓筆畫
弢	nue	中日韓兼容表意文字補充
勉	nuks	中日韓兼容表意文字
勉	nuks	中日韓兼容表意文字補充
弢	numk	中日韓兼容表意文字補充
⺄	nv	中日韓部首補充
⻠	nv	中日韓部首補充
㇅	nv	中日韓筆畫
㇈	nv	中日韓筆畫
㇊	nv	中日韓筆畫
㇍	nv	中日韓筆畫
⻢	nvsm	中日韓部首補充
⿻	nvwm	表意文字描述字符
⿂	nwf	康熙部首
魯	nwfa	中日韓兼容表意文字
勇	nwks	中日韓兼容表意文字補充
⻲	nwlu	中日韓部首補充
⻥	nwm	中日韓部首補充
⻳	nwu	中日韓部首補充
龜	nxu	中日韓兼容表意文字
龜	nxu	中日韓兼容表意文字
⿔	nxu	康熙部首
⺪	nylm	中日韓部首補充
⽦	nyo	康熙部首
⼈	o	康熙部首
㇏	o	中日韓筆畫
內	ob	中日韓兼容表意文字補充
⾁	obo	康熙部首
侻	ocru	中日韓兼容表意文字補充
僧	ocwa	中日韓兼容表意文字
僧	ocwa	中日韓兼容表意文字補充
⾫	og	康熙部首
⼊	oh	康熙部首
侀	ohjn	中日韓兼容表意文字
偺	ohya	中日韓兼容表意文字補充
⻟	oiai	中日韓部首補充
⻞	oias	中日韓部首補充
⾷	oiav	康熙部首
⻝	oiav	中日韓部首補充
䬳	oifq	中日韓兼容表意文字補充
飢	oilu	中日韓兼容表意文字補充
念	oinp	中日韓兼容表意文字
⺮	oioi	中日韓部首補充
餩	oioyo	中日韓兼容表意文字補充
什	oj	中日韓兼容表意文字
敏	ojok	中日韓兼容表意文字補充
⽸	oju	康熙部首
⽮	ok	康熙部首
⺙	ok	中日韓部首補充
僚	okcf	中日韓兼容表意文字
㺸	okmg	中日韓兼容表意文字補充
㺸	okmgi	中日韓兼容表意文字補充
繁	okvif	中日韓兼容表意文字
絛	olhef	中日韓兼容表意文字
領	olmbc	中日韓兼容表意文字
愈	ombp	中日韓兼容表意文字
全	omg	中日韓兼容表意文字
便	omlk	中日韓兼容表意文字
⽓	omn	康熙部首
例	omnn	中日韓兼容表意文字
⻐	omp	中日韓部首補充
⿕	omrb	康熙部首
令	omsl	中日韓兼容表意文字
像	onbo	中日韓兼容表意文字補充
㔕	onks	中日韓兼容表意文字補充
仌	oo	中日韓兼容表意文字補充
你	oof	中日韓兼容表意文字補充
倫	oomb	中日韓兼容表意文字
侮	oowj	中日韓兼容表意文字補充
侮	oowy	中日韓兼容表意文字
年	oq	中日韓兼容表意文字
鼅	orbus	中日韓兼容表意文字補充
舘	orjrr	中日韓兼容表意文字
鼅	orrxu	中日韓兼容表意文字補充
館	osjrr	中日韓兼容表意文字
飯	osme	中日韓兼容表意文字
飼	ossmr	中日韓兼容表意文字
備	otmb	中日韓兼容表意文字補充
㒞	ougs	中日韓兼容表意文字補充
𦈨	oumjj	中日韓兼容表意文字補充
𦉇	ousyj	中日韓兼容表意文字補充
缾	ouyjj	中日韓兼容表意文字
㇃	ov	中日韓筆畫
𪃎	ovhaf	中日韓兼容表意文字補充
倂	oyjj	中日韓兼容表意文字補充
𣫺	oykib	中日韓兼容表意文字補充
敏	oyok	中日韓兼容表意文字
⼼	p	康熙部首
𣊸	pavnb	中日韓兼容表意文字補充
惘	pbtv	中日韓兼容表意文字
眞	pbvc	中日韓兼容表意文字補充
㒹	pcpbc	中日韓兼容表意文字補充
憎	pcwa	中日韓兼容表意文字
憎	pcwa	中日韓兼容表意文字
憎	pcwa	中日韓兼容表意文字補充
懶	pdlc	中日韓兼容表意文字補充
𢛔	pdwf	中日韓兼容表意文字補充
憐	pfdq	中日韓兼容表意文字
慠	pgsk	中日韓兼容表意文字
𢡄	phka	中日韓兼容表意文字
𢡊	phkp	中日韓兼容表意文字
慨	phsu	中日韓兼容表意文字
勺	pi	中日韓兼容表意文字
悁	pib	中日韓兼容表意文字補充
㤜	pihm	中日韓兼容表意文字補充
慎	pjbc	中日韓兼容表意文字
駂	pjsqf	中日韓兼容表意文字補充
憤	pjtc	中日韓兼容表意文字補充
慎	pjuc	中日韓兼容表意文字補充
𠣞	pjwj	中日韓兼容表意文字補充
匆	pkk	中日韓兼容表意文字補充
懞	plbo	中日韓兼容表意文字補充
慺	pllv	中日韓兼容表意文字補充
勺	pm	中日韓兼容表意文字補充
忹	pmg	中日韓兼容表意文字補充
慄	pmwd	中日韓兼容表意文字
⻓	po	中日韓部首補充
怜	poml	中日韓兼容表意文字
悔	powj	中日韓兼容表意文字補充
悔	powy	中日韓兼容表意文字
⽐	pp	康熙部首
句	pr	中日韓兼容表意文字
切	psh	中日韓兼容表意文字
包	psu	中日韓兼容表意文字補充
慌	ptvu	中日韓兼容表意文字補充
慌	ptyu	中日韓兼容表意文字補充
惇	pysd	中日韓兼容表意文字補充
⻦	pysm	中日韓部首補充
㤺	pyvu	中日韓兼容表意文字補充
⼿	q	康熙部首
撝	qbhf	中日韓兼容表意文字補充
撚	qbkf	中日韓兼容表意文字
⽾	qd	康熙部首
𦔣	qdish	中日韓兼容表意文字補充
𢬌	qhie	中日韓兼容表意文字補充
契	qhk	中日韓兼容表意文字
揤	qhpl	中日韓兼容表意文字補充
㨮	qhsn	中日韓兼容表意文字補充
搜	qhxe	中日韓兼容表意文字
捐	qib	中日韓兼容表意文字補充
拔	qike	中日韓兼容表意文字補充
𢯱	qjfe	中日韓兼容表意文字補充
寿	qkdi	中日韓兼容表意文字補充
掩	qkhu	中日韓兼容表意文字補充
憯	qkua	中日韓兼容表意文字補充
⾭	qmb	康熙部首
⻘	qmb	中日韓部首補充
⾭	qmblm	康熙部首
搢	qmca	中日韓兼容表意文字補充
⻨	qme	中日韓部首補充
扝	qmjs	中日韓兼容表意文字補充
拓	qmr	中日韓兼容表意文字
摾	qnri	中日韓兼容表意文字補充
捨	qogr	中日韓兼容表意文字補充
捻	qoip	中日韓兼容表意文字
輦	qojwj	中日韓兼容表意文字
揄	qomn	中日韓兼容表意文字
拾	qomr	中日韓兼容表意文字
志	qp	中日韓兼容表意文字補充
抱	qpsu	中日韓兼容表意文字補充
⻙	qs	中日韓部首補充
挽	qshu	中日韓兼容表意文字補充
掃	qsmb	中日韓兼容表意文字補充
敖	qsok	中日韓兼容表意文字
摒	qsyj	中日韓兼容表意文字
摷	qvvd	中日韓兼容表意文字補充
㩬	qyci	中日韓兼容表意文字補充
拼	qyjj	中日韓兼容表意文字補充
擄	qyps	中日韓兼容表意文字
掠	qyrf	中日韓兼容表意文字
拉	qyt	中日韓兼容表意文字
⼝	r	康熙部首
嗢	rabt	中日韓兼容表意文字
喝	rapp	中日韓兼容表意文字
喝	rapv	中日韓兼容表意文字
⾢	rau	康熙部首
嗂	rbou	中日韓兼容表意文字補充
喳	rdbm	中日韓兼容表意文字補充
喇	rdln	中日韓兼容表意文字
噑	rhaj	中日韓兼容表意文字補充
吆	rhi	中日韓兼容表意文字補充
呂	rhr	中日韓兼容表意文字
噴	rjtc	中日韓兼容表意文字補充
⻪	rlwu	中日韓部首補充
呈	rmg	中日韓兼容表意文字補充
路	rmher	中日韓兼容表意文字
跋	rmike	中日韓兼容表意文字補充
趼	rmmjj	中日韓兼容表意文字補充
咞	rmt	中日韓兼容表意文字補充
跰	rmyjj	中日韓兼容表意文字補充
吸	rnhe	中日韓兼容表意文字補充
喙	rnmo	中日韓兼容表意文字
喙	rnmo	中日韓兼容表意文字補充
啣	roul	中日韓兼容表意文字補充
叱	rp	中日韓兼容表意文字補充
啕	rpov	中日韓兼容表意文字
喫	rqhk	中日韓兼容表意文字補充
鷺	rrhaf	中日韓兼容表意文字
器	rrikr	中日韓兼容表意文字
咢	rrmjs	中日韓兼容表意文字補充
嘆	rtao	中日韓兼容表意文字補充
嘆	rtlo	中日韓兼容表意文字
哶	rtq	中日韓兼容表意文字補充
⺒	ru	中日韓部首補充
巽	rutc	中日韓兼容表意文字補充
叫	rvl	中日韓兼容表意文字補充
⺠	rvp	中日韓部首補充
咽	rwk	中日韓兼容表意文字
黾	rwu	中日韓兼容表意文字補充
⿌	rxu	康熙部首
⻊	rylm	中日韓部首補充
⾜	ryo	康熙部首
⼫	s	康熙部首
層	scwa	中日韓兼容表意文字
尿	se	中日韓兼容表意文字
䵖	sehde	中日韓兼容表意文字補充
犀	sehq	中日韓兼容表意文字補充
駾	sfcru	中日韓兼容表意文字補充
駱	sfher	中日韓兼容表意文字
驪	sfmmp	中日韓兼容表意文字
⼑	sh	康熙部首
兔	shahi	中日韓兼容表意文字補充
免	shahu	中日韓兼容表意文字補充
免	shau	中日韓兼容表意文字
戮	shi	中日韓兼容表意文字
鬒	shjbc	中日韓兼容表意文字
鬒	shjbc	中日韓兼容表意文字補充
𡬘	shjtu	中日韓兼容表意文字補充
𩬰	shmhn	中日韓兼容表意文字補充
履	shoe	中日韓兼容表意文字
⾽	sihhh	康熙部首
⽿	sj	康熙部首
聰	sjhwp	中日韓兼容表意文字補充
屠	sjka	中日韓兼容表意文字補充
聆	sjoml	中日韓兼容表意文字
聯	sjvit	中日韓兼容表意文字
聠	sjyjj	中日韓兼容表意文字補充
刃	sk	中日韓兼容表意文字補充
忍	skp	中日韓兼容表意文字補充
⼙	sl	康熙部首
屢	sllv	中日韓兼容表意文字
臨	slorr	中日韓兼容表意文字
⾂	slsl	康熙部首
⺕	sm	中日韓部首補充
㣇	smhhb	中日韓兼容表意文字補充
⻒	smi	中日韓部首補充
⽻	smsim	康熙部首
羽	smsmm	中日韓兼容表意文字
⾧	smv	康熙部首
⻑	smv	中日韓部首補充
𣪍	snhne	中日韓兼容表意文字補充
⾺	sqsf	康熙部首
匿	stkr	中日韓兼容表意文字
⼰	su	康熙部首
⺋	su	中日韓部首補充
𤋮	suf	中日韓兼容表意文字
邔	sunl	中日韓兼容表意文字補充
莭	tail	中日韓兼容表意文字補充
𦳕	tajt	中日韓兼容表意文字補充
藺	tang	中日韓兼容表意文字
䕡	tanr	中日韓兼容表意文字補充
蘭	tanw	中日韓兼容表意文字
荣	tbd	中日韓兼容表意文字補充
菜	tbd	中日韓兼容表意文字補充
劳	tbks	中日韓兼容表意文字補充
益	tcbt	中日韓兼容表意文字
⿋	tcfb	康熙部首
㭉	td	中日韓兼容表意文字補充
落	tehr	中日韓兼容表意文字
𦼬	temt	中日韓兼容表意文字補充
蓱	teyj	中日韓兼容表意文字補充
⺷	tg	中日韓部首補充
菱	tgce	中日韓兼容表意文字
𦰶	tgpr	中日韓兼容表意文字補充
善	tgtr	中日韓兼容表意文字補充
羕	tgye	中日韓兼容表意文字補充
⾸	thbu	康熙部首
䕝	thdb	中日韓兼容表意文字補充
蘒	thdu	中日韓兼容表意文字
菧	tihp	中日韓兼容表意文字補充
芝	tino	中日韓兼容表意文字補充
著	tjka	中日韓兼容表意文字
著	tjka	中日韓兼容表意文字補充
勒	tjks	中日韓兼容表意文字
苦	tjr	中日韓兼容表意文字補充
䩮	tjsme	中日韓兼容表意文字補充
䩶	tjumi	中日韓兼容表意文字補充
若	tkr	中日韓兼容表意文字
若	tkr	中日韓兼容表意文字補充
莽	tkt	中日韓兼容表意文字補充
𧏊	tlii	中日韓兼容表意文字補充
⾰	tlj	康熙部首
⻩	tlwc	中日韓部首補充
⽢	tm	康熙部首
𦵫	tmbf	中日韓兼容表意文字補充
芋	tmd	中日韓兼容表意文字補充
黹	tmfb	中日韓兼容表意文字補充
⺸	tmj	中日韓部首補充
勤	tmks	中日韓兼容表意文字
勤	tmks	中日韓兼容表意文字補充
⿈	tmlc	康熙部首
華	tmtj	中日韓兼容表意文字
芽	tmvh	中日韓兼容表意文字補充
䔫	tnmb	中日韓兼容表意文字補充
茶	tod	中日韓兼容表意文字
𦬼	tof	中日韓兼容表意文字補充
蕤	tohqm	中日韓兼容表意文字補充
難	toog	中日韓兼容表意文字
難	toog	中日韓兼容表意文字
花	top	中日韓兼容表意文字補充
菊	tpfd	中日韓兼容表意文字補充
葉	tptd	中日韓兼容表意文字
⽺	tq	康熙部首
⺶	tq	中日韓部首補充
着	tqbu	中日韓兼容表意文字
羚	tqoml	中日韓兼容表意文字
𦾱	tqvd	中日韓兼容表意文字補充
茣	trmk	中日韓兼容表意文字補充
敬	trok	中日韓兼容表意文字補充
𠔥	tsf	中日韓兼容表意文字補充
茝	tsll	中日韓兼容表意文字補充
蓼	tsmh	中日韓兼容表意文字
藍	tsmt	中日韓兼容表意文字
芑	tsu	中日韓兼容表意文字補充
蓳	ttlm	中日韓兼容表意文字補充
並	ttm	中日韓兼容表意文字
善	ttr	中日韓兼容表意文字補充
𧃒	tvfv	中日韓兼容表意文字補充
甆	tvin	中日韓兼容表意文字
慈	tvip	中日韓兼容表意文字補充
菉	tvne	中日韓兼容表意文字
荒	tvou	中日韓兼容表意文字
菌	twhd	中日韓兼容表意文字補充
蘿	twlg	中日韓兼容表意文字
夢	twln	中日韓兼容表意文字補充
䕫	tyce	中日韓兼容表意文字補充
蓮	tyjj	中日韓兼容表意文字
荓	tyjj	中日韓兼容表意文字補充
蔖	typm	中日韓兼容表意文字補充
蘆	typt	中日韓兼容表意文字
⼭	u	康熙部首
屮	uh	中日韓兼容表意文字補充
⼔	uh	康熙部首
⼬	uh	康熙部首
嵐	uhni	中日韓兼容表意文字
⾿	uip	康熙部首
炭	ukf	中日韓兼容表意文字補充
屮	ul	中日韓兼容表意文字
屮	ul	中日韓兼容表意文字補充
⼬	ul	康熙部首
峀	ulw	中日韓兼容表意文字補充
岍	umjj	中日韓兼容表意文字補充
蚩	umli	中日韓兼容表意文字補充
蚩	umlmi	中日韓兼容表意文字補充
豈	umrt	中日韓兼容表意文字
嶲	uogs	中日韓兼容表意文字補充
嶺	uolc	中日韓兼容表意文字
崙	uomb	中日韓兼容表意文字
嵮	upbc	中日韓兼容表意文字補充
𡷤	urvk	中日韓兼容表意文字補充
嵫	utvi	中日韓兼容表意文字補充
⾋	uu	康熙部首
芳	uuyhs	中日韓兼容表意文字補充
𡴋	uwyi	中日韓兼容表意文字補充
嵃	uyhh	中日韓兼容表意文字補充
嵼	uyhm	中日韓兼容表意文字補充
女	v	中日韓兼容表意文字
⼥	v	康熙部首
㇙	v	中日韓筆畫
娧	vcru	中日韓兼容表意文字補充
嬾	vdlc	中日韓兼容表意文字補充
嬾	vdlc	中日韓兼容表意文字補充
鄛	vdnl	中日韓兼容表意文字補充
怒	vep	中日韓兼容表意文字
拏	veq	中日韓兼容表意文字
縂	vfcrp	中日韓兼容表意文字補充
練	vfdw	中日韓兼容表意文字
練	vfdwf	中日韓兼容表意文字
練	vfdwf	中日韓兼容表意文字
綾	vfgce	中日韓兼容表意文字
鸞	vfhaf	中日韓兼容表意文字
變	vfhe	中日韓兼容表意文字補充
縷	vfllv	中日韓兼容表意文字
縉	vfmca	中日韓兼容表意文字
䌁	vfmwv	中日韓兼容表意文字補充
紐	vfng	中日韓兼容表意文字
綠	vfnve	中日韓兼容表意文字
戀	vfp	中日韓兼容表意文字
紀	vfsu	中日韓兼容表意文字補充
緇	vfvmw	中日韓兼容表意文字補充
𥾆	vfvu	中日韓兼容表意文字補充
繅	vfvvd	中日韓兼容表意文字補充
絣	vfyjj	中日韓兼容表意文字補充
䌴	vfyqq	中日韓兼容表意文字補充
嬈	vggn	中日韓兼容表意文字補充
⼛	vi	康熙部首
⼳	vi	康熙部首
⺓	vi	中日韓部首補充
樂	vid	中日韓兼容表意文字
樂	vid	中日韓兼容表意文字
樂	vid	中日韓兼容表意文字
⽷	vif	康熙部首
⺯	vif	中日韓部首補充
㛮	vjce	中日韓兼容表意文字補充
𡛪	vkuh	中日韓兼容表意文字補充
凵	vl	中日韓兼容表意文字補充
⼐	vl	康熙部首
⺃	vl	中日韓部首補充
㇟	vl	中日韓筆畫
蠁	vllmi	中日韓兼容表意文字補充
響	vlyta	中日韓兼容表意文字
響	vlyta	中日韓兼容表意文字
㇜	vm	中日韓筆畫
災	vmf	中日韓兼容表意文字補充
𦇚	vmftf	中日韓兼容表意文字補充
狀	vmik	中日韓兼容表意文字
㛼	vmjx	中日韓兼容表意文字補充
⽙	vml	康熙部首
甾	vmw	中日韓兼容表意文字補充
㇞	vn	中日韓筆畫
⺔	vnm	中日韓部首補充
𡚨	vp	中日韓兼容表意文字補充
娛	vrvk	中日韓兼容表意文字補充
㇉	vs	中日韓筆畫
姬	vsll	中日韓兼容表意文字補充
婦	vsmb	中日韓兼容表意文字補充
嬨	vtvp	中日韓兼容表意文字
巢	vvhxd	中日韓兼容表意文字補充
⺰	vvm	中日韓部首補充
⻡	vvmbu	中日韓部首補充
⼮	vvv	康熙部首
婢	vwhj	中日韓兼容表意文字
姘	vyjj	中日韓兼容表意文字補充
⽥	w	康熙部首
⿵	wb	表意文字描述字符
㱎	wfno	中日韓兼容表意文字補充
里	wg	中日韓兼容表意文字
⾥	wg	康熙部首
⿊	wgf	康熙部首
墨	wgfg	中日韓兼容表意文字
略	wher	中日韓兼容表意文字
圗	wiyw	中日韓兼容表意文字補充
⽏	wj	康熙部首
⿰	wl	表意文字描述字符
𥄳	wle	中日韓兼容表意文字補充
署	wljka	中日韓兼容表意文字
⺫	wll	中日韓部首補充
⺲	wll	中日韓部首補充
⿲	wll	表意文字描述字符
䍙	wlowy	中日韓兼容表意文字補充
罹	wlpog	中日韓兼容表意文字
羅	wlvfg	中日韓兼容表意文字
𦌾	wlvfv	中日韓兼容表意文字補充
罺	wlvvd	中日韓兼容表意文字補充
⿸	wml	表意文字描述字符
〾	wmq	表意文字描述字符
⿹	wn	表意文字描述字符
囹	woml	中日韓兼容表意文字
〾	woq	表意文字描述字符
⿴	wr	表意文字描述字符
圖	wrjw	中日韓兼容表意文字補充
⿷	ws	表意文字描述字符
異	wtc	中日韓兼容表意文字
異	wtc	中日韓兼容表意文字補充
𤲒	wtt	中日韓兼容表意文字補充
⿶	wu	表意文字描述字符
⿺	wv	表意文字描述字符
累	wvif	中日韓兼容表意文字
⿻	ww	表意文字描述字符
壘	wwwg	中日韓兼容表意文字
貫	wybuc	中日韓兼容表意文字補充
⺟	wyi	中日韓部首補充
㇣	xxxxx	中日韓筆畫
⼘	y	康熙部首
望	ybhg	中日韓兼容表意文字
望	ybmg	中日韓兼容表意文字補充
離	ybog	中日韓兼容表意文字
龍	ybysp	中日韓兼容表意文字
⿓	ybysp	康熙部首
六	yc	中日韓兼容表意文字
歔	ycno	中日韓兼容表意文字補充
𣀊	ycok	中日韓兼容表意文字補充
⽁	ye	康熙部首
虧	ygmjs	中日韓兼容表意文字補充
⼴	yh	康熙部首
頻	yhmbc	中日韓兼容表意文字
頻	yhmbc	中日韓兼容表意文字
⽅	yhs	康熙部首
⾐	yhv	康熙部首
𨗭	yhxg	中日韓兼容表意文字補充
育	yib	中日韓兼容表意文字補充
充	yihu	中日韓兼容表意文字
𠘺	yihu	中日韓兼容表意文字補充
率	yioj	中日韓兼容表意文字
率	yioj	中日韓兼容表意文字
⽃	yj	康熙部首
贛	yjhec	中日韓兼容表意文字補充
連	yjwj	中日韓兼容表意文字
頩	yjyjc	中日韓兼容表意文字補充
鵧	yjyjf	中日韓兼容表意文字補充
郱	yjyjl	中日韓兼容表意文字補充
⽂	yk	康熙部首
遼	ykcf	中日韓兼容表意文字
⻬	ykll	中日韓部首補充
吝	ykr	中日韓兼容表意文字
⻫	yksl	中日韓部首補充
⽌	ylm	康熙部首
⺡	ym	中日韓部首補充
𨗒	ymbg	中日韓兼容表意文字補充
歲	ymihf	中日韓兼容表意文字補充
剷	ymln	中日韓兼容表意文字補充
⾔	ymmr	康熙部首
𢌱	ymt	中日韓兼容表意文字補充
𢌱	ymt	中日韓兼容表意文字補充
⻭	ymufd	中日韓部首補充
⻮	ymuo	中日韓部首補充
⿒	ymuoo	康熙部首
逸	ynai	中日韓兼容表意文字
逸	ynai	中日韓兼容表意文字
⺞	yni	中日韓部首補充
⻍	yno	中日韓部首補充
刻	yoln	中日韓兼容表意文字補充
衣	yoo	中日韓兼容表意文字補充
⾌	yp	康熙部首
壟	ypg	中日韓兼容表意文字
⻁	yphn	中日韓部首補充
聾	ypsj	中日韓兼容表意文字
虐	ypsm	中日韓兼容表意文字補充
盧	ypwbt	中日韓兼容表意文字
虜	ypwks	中日韓兼容表意文字
虜	ypwks	中日韓兼容表意文字補充
謁	yrapp	中日韓兼容表意文字
謁	yrapv	中日韓兼容表意文字
調	yrbgr	中日韓兼容表意文字
⾼	yrbr	康熙部首
亮	yrbu	中日韓兼容表意文字
䛇	yrcr	中日韓兼容表意文字補充
說	yrcru	中日韓兼容表意文字
說	yrcru	中日韓兼容表意文字
讀	yrgwc	中日韓兼容表意文字
誠	yrihl	中日韓兼容表意文字補充
諸	yrjka	中日韓兼容表意文字
諸	yrjka	中日韓兼容表意文字
䚾	yrmg	中日韓兼容表意文字補充
𧥦	yrmms	中日韓兼容表意文字補充
論	yromb	中日韓兼容表意文字
諭	yromn	中日韓兼容表意文字
諭	yromv	中日韓兼容表意文字補充
請	yrqmb	中日韓兼容表意文字
謹	yrtag	中日韓兼容表意文字
諾	yrtkr	中日韓兼容表意文字
諾	yrtkr	中日韓兼容表意文字
謹	yrtlm	中日韓兼容表意文字
識	yryia	中日韓兼容表意文字
諒	yryrf	中日韓兼容表意文字
遲	yseq	中日韓兼容表意文字
旅	ysohv	中日韓兼容表意文字
立	yt	中日韓兼容表意文字
⽴	yt	康熙部首
暜	yta	中日韓兼容表意文字補充
⾳	yta	康熙部首
⾟	ytj	康熙部首
𥪧	ytjbc	中日韓兼容表意文字補充
𥪧	ytpbc	中日韓兼容表意文字補充
靖	ytqmb	中日韓兼容表意文字
靖	ytqmb	中日韓兼容表意文字
竮	ytsyj	中日韓兼容表意文字補充
⻯	ytwu	中日韓部首補充
𪘀	yuyjj	中日韓兼容表意文字補充
變	yvfw	中日韓兼容表意文字
巡	yvvv	中日韓兼容表意文字補充
裏	ywgv	中日韓兼容表意文字
⿄	ywii	康熙部首
⻧	ywk	中日韓部首補充
邏	ywlg	中日韓兼容表意文字
⿑	yx	康熙部首